size=6x6
Level2-Level3
xxxxxx
x*+-*x
x****x
x*//*x
x****x
xx^xxx